{
    "sprite sheet": "assets\\basetiles.png",
    "assetsDir": "assets\\",
    "physics":{
        "gravity":300
    },
    "player": {
        "start": [500.0, 100.0],
        "animation": {
            "use": true,
            "animations": {
                "s": {
                    "file": "player1.png",
                    "rect": [0, 0, 32, 32],
                    "frames": 1,
                    "loop": true
                },
                "r": {
                    "file":"player_right.png",
                    "rect": [0, 0, 32, 32],
                    "frames":25, 
                    "loop":true
                },
                "l": {
                    "file":"player_left.png",
                    "rect": [0, 0, 32, 32],
                    "frames":25, 
                    "loop":true
                }
            }
        },
        "image": "player1.png",
        "box": [30, 32],
        "collision": true,
        "solid": true,
        "maxspeed": 180.0,
        "maxjump": 600.0,
        "acceleration": 1200
    },
    "objects": [{
        "id": "dark_1_32x32.png",
        "imageat": [0, 0, 32, 32],
        "collision": true,
        "oncollision": null,
        "solid": false,
        "box": [32, 32],
        "friction": 300,
        "colorval": [64, 0, 128]
    }, {
        "id": "dark_2_32x32.png",
        "imageat": [32, 0, 32, 32],
        "collision": true,
        "oncollision": null,
        "solid": false,
        "box": [32, 32],
        "friction": 300,
        "colorval": [32, 0, 96]
    }, {
        "id": "dark_3_32x32.png",
        "imageat": [0, 32, 32, 32],
        "collision": true,
        "oncollision": null,
        "solid": false,
        "box": [32, 32],
        "friction": 300,
        "colorval": [96, 16, 160]
    }, {
        "id": "dark_4_32x32.png",
        "imageat": [32, 32, 32, 32],
        "collision": true,
        "oncollision": null,
        "solid": false,
        "box": [32, 32],
        "friction": 300,
        "colorval": [96, 16, 192]
    }, {
        "id": "dark_5_32x32.png",
        "imageat": [0, 64, 32, 32],
        "collision": true,
        "oncollision": null,
        "solid": false,
        "box": [32, 32],
        "friction": 300,
        "colorval": [96, 32, 224]
    }, {
        "id": "dirt_32x32.png",
        "imageat": [32, 64, 32, 32],
        "collision": true,
        "oncollision": null,
        "solid": true,
        "box": [32, 32],
        "friction": 300,
        "colorval": [128, 64, 0]
    }, {
        "id": "grass_32x32.png",
        "imageat": [0, 96, 32, 32],
        "collision": true,
        "oncollision": null,
        "solid": true,
        "box": [32, 32],
        "friction": 300,
        "colorval": [0, 192, 64]
    }, {
        "id": "grass_dead_32x32.png",
        "imageat": [32, 96, 32, 32],
        "collision": true,
        "oncollision": null,
        "solid": true,
        "box": [32, 32],
        "friction": 300,
        "colorval": [216, 192, 64]
    }, {
        "id": "planks_2_32x32.png",
        "imageat": [0, 128, 32, 32],
        "collision": true,
        "oncollision": null,
        "solid": true,
        "box": [32, 32],
        "friction": 300,
        "colorval": [216, 128, 216]
    }, {
        "id": "planks_32x32.png",
        "imageat": [32, 128, 32, 32],
        "collision": true,
        "oncollision": null,
        "solid": true,
        "box": [32, 32],
        "friction": 300,
        "colorval": [216, 0, 216]
    }, {
        "id": "poles_32x32.png",
        "imageat": [0, 160, 32, 32],
        "collision": true,
        "oncollision": null,
        "solid": false,
        "box": [32, 32],
        "friction": 300,
        "colorval": [255, 192, 255]
    }, {
        "id": "sand_2_32x32.png",
        "imageat": [32, 160, 32, 32],
        "collision": true,
        "oncollision": null,
        "solid": true,
        "box": [32, 32],
        "friction": 300,
        "colorval": [255, 192, 0]
    }, {
        "id": "sand_32x32.png",
        "imageat": [0, 192, 32, 32],
        "collision": true,
        "oncollision": null,
        "solid": true,
        "box": [32, 32],
        "friction": 300,
        "colorval": [216, 128, 0]
    }, {
        "id": "stone_1_32x32.png",
        "imageat": [32, 192, 32, 32],
        "collision": true,
        "oncollision": null,
        "solid": true,
        "box": [32, 32],
        "friction": 300,
        "colorval": [64, 64, 64]
    }, {
        "id": "stone_2_32x32.png",
        "imageat": [0, 224, 32, 32],
        "collision": true,
        "oncollision": null,
        "solid": true,
        "box": [32, 32],
        "friction": 300,
        "colorval": [96, 96, 96]
    }, {
        "id": "stone_3_32x32.png",
        "imageat": [32, 224, 32, 32],
        "collision": true,
        "oncollision": null,
        "solid": true,
        "box": [32, 32],
        "friction": 300,
        "colorval": [128, 128, 128]
    }, {
        "id": "stone_4_32x32.png",
        "imageat": [0, 256, 32, 32],
        "collision": true,
        "oncollision": null,
        "solid": true,
        "box": [32, 32],
        "friction": 300,
        "colorval": [160, 160, 160]
    }, {
        "id": "stone_5_32x32.png",
        "imageat": [32, 256, 32, 32],
        "collision": true,
        "oncollision": null,
        "solid": true,
        "box": [32, 32],
        "friction": 300,
        "colorval": [192, 192, 192]
    },{
        "id": "water_1_32x32.png",
        "imageat": [0, 288, 32, 32],
        "collision": true,
        "oncollision": null,
        "solid": true,
        "box": [32, 32],
        "friction": 300,
        "colorval": [0, 0, 192]
    }],
    "map": [
        [9, 0, 0, 0, 0, 0, 0, 0, 0, 0, 0, 0, 0, 0, 0, 0, 0, 0, 0, 0, 0, 0, 0, 0, 0, 0, 0, 0, 0, 0, 0, 0, 0, 0, 0, 0, 0, 0, 0, 0, 0, 0, 0, 0, 0, 0, 0, 0, 0, 0, 14, 14, 14, 14, 14, 14, 14, 14, 14, 14, 14, 14, 14, 14, 14, 14],
        [9, 0, 0, 0, 0, 0, 0, 0, 0, 0, 0, 0, 0, 0, 0, 0, 0, 0, 0, 0, 0, 0, 0, 0, 0, 0, 0, 0, 0, 0, 0, 0, 0, 0, 0, 0, 0, 0, 0, 0, 0, 0, 0, 0, 0, 0, 0, 0, 0, 0, 14, 14, 14, 14, 14, 14, 14, 14, 14, 14, 14, 14, 14, 14, 14, 14],
        [9, 0, 0, 0, 0, 0, 0, 0, 0, 0, 0, 0, 0, 0, 0, 0, 0, 0, 0, 0, 0, 0, 0, 0, 0, 0, 0, 0, 0, 0, 0, 0, 0, 0, 0, 0, 0, 0, 0, 0, 0, 0, 0, 0, 0, 0, 0, 0, 0, 0, 0, 14, 14, 14, 14, 14, 14, 14, 14, 14, 14, 14, 14, 14, 14, 14],
        [9, 0, 0, 0, 0, 0, 0, 0, 0, 0, 0, 0, 0, 0, 0, 0, 0, 0, 0, 0, 0, 0, 0, 0, 0, 0, 10, 10, 9, 10, 10, 0, 0, 0, 0, 0, 0, 0, 0, 0, 0, 0, 0, 0, 0, 0, 0, 0, 0, 0, 0, 0, 14, 14, 14, 14, 14, 14, 14, 14, 14, 14, 14, 14, 14, 14],
        [9, 0, 0, 0, 0, 0, 0, 0, 0, 0, 0, 0, 0, 0, 0, 0, 0, 0, 0, 0, 0, 0, 0, 0, 0, 0, 0, 0, 11, 0, 0, 0, 0, 0, 0, 0, 0, 0, 0, 0, 0, 0, 0, 0, 0, 0, 0, 0, 0, 0, 0, 0, 0, 0, 14, 14, 14, 14, 14, 14, 14, 14, 14, 14, 14, 14],
        [9, 0, 0, 0, 0, 0, 0, 0, 0, 0, 0, 0, 0, 0, 0, 9, 10, 10, 10, 10, 0, 0, 0, 0, 0, 0, 0, 0, 11, 0, 0, 0, 0, 0, 0, 0, 0, 0, 0, 0, 0, 0, 0, 0, 0, 0, 0, 0, 0, 0, 0, 0, 0, 0, 0, 0, 14, 14, 14, 14, 14, 14, 14, 14, 14, 14],
        [9, 0, 0, 0, 0, 0, 0, 0, 0, 0, 0, 0, 0, 0, 0, 11, 0, 0, 0, 0, 0, 0, 0, 0, 0, 0, 0, 0, 11, 0, 0, 0, 0, 0, 0, 0, 0, 0, 0, 0, 0, 15, 15, 15, 15, 15, 15, 15, 15, 15, 15, 0, 0, 0, 0, 0, 0, 0, 14, 14, 14, 14, 14, 14, 14, 14],
        [9, 0, 0, 0, 0, 0, 0, 0, 0, 0, 0, 0, 0, 0, 0, 11, 0, 0, 0, 0, 0, 0, 0, 0, 0, 0, 0, 0, 11, 0, 0, 0, 0, 0, 0, 0, 0, 0, 0, 15, 15, 14, 14, 14, 14, 14, 14, 14, 14, 14, 14, 15, 15, 15, 0, 0, 0, 0, 0, 14, 14, 14, 14, 14, 14, 14],
        [9, 0, 0, 0, 0, 0, 0, 0, 0, 0, 0, 0, 0, 0, 0, 11, 0, 0, 0, 0, 0, 0, 0, 0, 0, 0, 0, 0, 11, 0, 0, 0, 0, 0, 0, 0, 0, 15, 15, 14, 14, 14, 14, 14, 14, 14, 14, 14, 14, 14, 14, 14, 14, 14, 15, 0, 0, 0, 0, 2, 14, 14, 14, 14, 14, 14],
        [9, 0, 0, 0, 10, 10, 9, 10, 10, 10, 0, 0, 0, 0, 0, 11, 0, 0, 0, 0, 0, 0, 0, 0, 0, 0, 0, 0, 11, 0, 0, 0, 0, 0, 0, 0, 15, 14, 14, 14, 14, 14, 14, 14, 14, 14, 14, 14, 14, 14, 14, 14, 14, 14, 14, 15, 15, 15, 0, 1, 14, 14, 14, 14, 14, 14],
        [9, 0, 0, 0, 0, 0, 9, 10, 0, 0, 0, 0, 0, 0, 0, 11, 0, 0, 0, 0, 0, 0, 0, 0, 0, 0, 0, 0, 11, 0, 0, 0, 0, 0, 0, 0, 14, 14, 14, 14, 14, 14, 14, 14, 14, 14, 14, 14, 14, 14, 14, 14, 14, 14, 14, 14, 14, 14, 15, 15, 14, 14, 14, 14, 14, 14],
        [9, 0, 0, 0, 0, 0, 11, 0, 0, 0, 0, 0, 0, 0, 0, 11, 0, 0, 0, 0, 0, 0, 0, 0, 0, 0, 0, 0, 11, 0, 0, 0, 0, 0, 0, 0, 14, 14, 14, 14, 14, 14, 14, 14, 14, 14, 14, 14, 14, 14, 14, 14, 14, 14, 14, 14, 14, 14, 14, 14, 14, 14, 14, 14, 14, 14],
        [9, 0, 0, 0, 0, 0, 11, 0, 0, 0, 0, 0, 0, 0, 0, 11, 0, 0, 0, 0, 0, 0, 0, 0, 0, 0, 0, 0, 11, 0, 0, 0, 0, 0, 0, 0, 14, 14, 14, 14, 14, 14, 14, 14, 14, 14, 14, 14, 14, 14, 14, 14, 14, 14, 14, 14, 14, 14, 14, 14, 14, 14, 14, 14, 14, 14],
        [9, 0, 0, 0, 0, 0, 11, 0, 10, 10, 10, 10, 10, 0, 0, 11, 0, 0, 0, 0, 0, 0, 0, 0, 0, 0, 0, 0, 11, 0, 0, 0, 0, 0, 0, 0, 0, 14, 14, 14, 14, 14, 14, 14, 14, 14, 14, 14, 14, 14, 14, 14, 14, 14, 14, 14, 14, 14, 14, 14, 14, 14, 14, 14, 14, 14],
        [9, 0, 0, 0, 0, 0, 11, 0, 0, 0, 11, 0, 0, 0, 0, 11, 0, 0, 0, 0, 0, 0, 0, 0, 0, 0, 0, 0, 11, 0, 0, 0, 0, 0, 0, 0, 0, 0, 14, 14, 14, 14, 14, 14, 14, 14, 14, 14, 14, 14, 14, 14, 14, 14, 14, 14, 14, 14, 14, 14, 14, 14, 14, 14, 14, 14],
        [9, 0, 0, 0, 0, 0, 11, 0, 0, 0, 11, 0, 0, 0, 0, 11, 0, 0, 0, 0, 0, 0, 0, 0, 0, 0, 0, 0, 11, 0, 0, 0, 0, 0, 0, 0, 0, 0, 0, 0, 0, 0, 0, 14, 14, 14, 14, 14, 14, 14, 14, 14, 14, 14, 14, 14, 14, 14, 14, 14, 14, 14, 14, 14, 14, 14],
        [9, 0, 0, 0, 0, 0, 11, 0, 0, 0, 11, 0, 0, 0, 0, 11, 0, 0, 0, 0, 0, 0, 0, 0, 0, 0, 0, 0, 11, 0, 0, 0, 0, 0, 0, 0, 0, 0, 0, 0, 0, 0, 0, 0, 0, 14, 14, 14, 14, 14, 14, 14, 14, 14, 14, 14, 14, 14, 14, 14, 14, 14, 14, 14, 14, 14],
        [9, 0, 0, 0, 0, 0, 11, 0, 0, 0, 11, 0, 0, 0, 0, 11, 9, 10, 10, 10, 0, 0, 0, 0, 0, 0, 0, 0, 11, 0, 0, 0, 0, 0, 0, 0, 0, 0, 0, 0, 0, 0, 0, 0, 0, 0, 14, 14, 14, 14, 14, 14, 14, 14, 14, 14, 14, 14, 14, 14, 14, 14, 14, 14, 14, 14],
        [9, 0, 0, 0, 0, 0, 9, 10, 10, 10, 9, 0, 0, 0, 0, 11, 0, 0, 0, 0, 0, 0, 0, 0, 0, 0, 0, 0, 11, 0, 0, 0, 0, 0, 0, 0, 0, 0, 0, 0, 0, 0, 0, 0, 0, 0, 0, 0, 14, 14, 14, 14, 14, 14, 14, 14, 14, 14, 14, 14, 14, 14, 14, 14, 14, 14],
        [9, 0, 0, 0, 0, 0, 11, 0, 0, 0, 0, 0, 0, 0, 0, 11, 0, 0, 0, 0, 0, 0, 10, 10, 9, 10, 0, 0, 11, 0, 0, 0, 0, 0, 0, 0, 0, 0, 0, 0, 0, 0, 0, 0, 0, 0, 0, 0, 0, 14, 14, 14, 14, 14, 14, 14, 14, 14, 14, 14, 14, 14, 14, 14, 14, 14],
        [9, 0, 0, 0, 0, 0, 11, 0, 0, 0, 0, 0, 0, 0, 0, 11, 0, 0, 0, 0, 0, 0, 0, 0, 11, 0, 0, 0, 11, 0, 0, 0, 0, 0, 0, 0, 0, 0, 0, 0, 0, 0, 0, 0, 0, 0, 0, 0, 0, 0, 14, 14, 14, 14, 14, 14, 14, 14, 14, 14, 14, 14, 14, 14, 14, 14],
        [9, 0, 0, 0, 0, 0, 11, 0, 0, 0, 0, 0, 0, 0, 0, 11, 0, 0, 0, 0, 0, 0, 0, 0, 11, 0, 0, 0, 11, 0, 0, 0, 0, 0, 0, 0, 0, 0, 0, 0, 0, 0, 0, 0, 0, 0, 0, 0, 0, 0, 0, 14, 14, 14, 14, 14, 14, 14, 14, 14, 14, 14, 14, 14, 14, 14],
        [9, 0, 0, 0, 0, 0, 11, 0, 0, 0, 0, 0, 0, 0, 0, 11, 0, 0, 0, 0, 0, 0, 0, 0, 11, 0, 0, 0, 11, 0, 0, 0, 0, 0, 0, 0, 0, 0, 0, 0, 0, 0, 0, 0, 0, 0, 0, 0, 0, 0, 0, 14, 14, 14, 14, 14, 14, 14, 14, 14, 14, 14, 14, 14, 14, 14],
        [9, 0, 0, 0, 0, 0, 11, 0, 0, 0, 0, 0, 0, 0, 10, 9, 10, 10, 0, 0, 0, 0, 0, 0, 11, 0, 0, 0, 11, 0, 0, 0, 0, 0, 0, 0, 0, 0, 0, 0, 0, 0, 0, 0, 0, 0, 0, 0, 0, 0, 0, 14, 14, 14, 14, 14, 14, 14, 14, 14, 14, 14, 14, 14, 14, 14],
        [9, 0, 0, 0, 0, 0, 11, 0, 0, 0, 0, 0, 0, 0, 0, 11, 0, 0, 0, 0, 0, 0, 0, 0, 11, 0, 0, 0, 11, 0, 0, 0, 0, 0, 0, 0, 0, 0, 0, 0, 0, 0, 15, 15, 15, 0, 0, 0, 0, 0, 0, 0, 14, 14, 14, 14, 14, 14, 14, 14, 14, 14, 14, 14, 14, 14],
        [9, 0, 0, 0, 0, 0, 9, 10, 10, 10, 10, 0, 0, 0, 0, 11, 0, 0, 0, 0, 0, 0, 0, 0, 11, 0, 0, 0, 11, 0, 0, 0, 0, 0, 0, 0, 0, 0, 0, 0, 0, 0, 14, 14, 14, 15, 15, 0, 0, 0, 0, 0, 14, 14, 14, 14, 14, 14, 14, 14, 14, 14, 14, 14, 14, 14],
        [9, 0, 0, 0, 0, 0, 11, 0, 0, 0, 0, 0, 0, 0, 0, 11, 0, 0, 0, 0, 0, 0, 0, 0, 11, 0, 0, 0, 11, 0, 0, 0, 0, 0, 0, 0, 0, 0, 0, 0, 0, 0, 14, 14, 14, 14, 14, 15, 15, 15, 0, 0, 14, 14, 14, 14, 14, 14, 14, 14, 14, 14, 14, 14, 14, 14],
        [9, 0, 0, 0, 0, 0, 11, 0, 0, 0, 0, 0, 0, 0, 0, 11, 0, 0, 0, 0, 0, 0, 0, 0, 11, 0, 0, 0, 11, 0, 0, 0, 0, 0, 0, 0, 0, 0, 0, 0, 15, 15, 14, 14, 14, 14, 14, 14, 14, 14, 15, 15, 14, 14, 14, 14, 14, 14, 14, 14, 14, 14, 14, 14, 14, 14],
        [9, 0, 0, 0, 0, 0, 11, 0, 0, 0, 0, 10, 9, 10, 10, 9, 10, 0, 0, 0, 0, 0, 0, 0, 11, 0, 0, 0, 11, 0, 0, 0, 0, 0, 0, 0, 0, 15, 15, 15, 15, 14, 14, 14, 14, 14, 14, 14, 14, 14, 14, 14, 14, 14, 14, 14, 14, 14, 14, 14, 14, 14, 14, 14, 14, 14],
        [9, 0, 0, 0, 0, 0, 11, 0, 0, 0, 0, 0, 11, 0, 0, 11, 0, 0, 0, 0, 0, 0, 0, 0, 7, 7, 7, 7, 11, 0, 0, 0, 0, 0, 15, 15, 15, 14, 14, 14, 14, 14, 14, 14, 14, 14, 14, 14, 14, 14, 14, 14, 14, 14, 14, 14, 14, 14, 14, 14, 14, 14, 14, 14, 14, 14],
        [9, 0, 0, 0, 0, 0, 11, 0, 0, 0, 0, 0, 11, 0, 0, 11, 0, 0, 0, 0, 0, 0, 7, 7, 6, 6, 6, 6, 7, 7, 0, 0, 0, 0, 14, 14, 14, 14, 14, 14, 14, 14, 14, 14, 14, 14, 14, 14, 14, 14, 14, 14, 14, 14, 14, 14, 14, 14, 14, 14, 14, 14, 14, 14, 14, 14],
        [19, 19, 19, 19, 19, 19, 7, 7, 7, 7, 7, 7, 7, 7, 7, 7, 7, 7, 7, 7, 7, 7, 7, 6, 6, 6, 6, 6, 6, 7, 7, 7, 7, 7, 14, 14, 14, 14, 14, 14, 14, 14, 14, 14, 14, 14, 14, 14, 14, 14, 14, 14, 14, 14, 14, 14, 14, 14, 14, 14, 14, 14, 14, 14, 14, 14]
    ]
}